España	NP	España
entra	VLfin	entrar
en	PREP	en
la	ART	el
fase	NC	fase
decisiva	ADJ	decisivo
para	CSUBI	para
hacerse	VCLIinf	hacerse
con	PREP	con
la	ART	el
vicepresidencia	NC	vicepresidencia
del	PDEL	del
BCE	NP	<unknown>
https	NC	<unknown>
:	COLON	:
//elpais	VLfin	<unknown>
.	FS	.
com/economia/2018/01/22/actualidad/1516614618_752845	VLfin	<unknown>
.	FS	.
html	NC	<unknown>
El	ART	el
Eurogrupo	NP	<unknown>
abre	VLfin	abrir
este	DM	este
lunes	NC	lunes
el	ART	el
plazo	NC	plazo
para	CSUBI	para
presentar	VLinf	presentar
candidaturas	NC	candidatura
sin	PREP	sin
que	CQUE	que
el	ART	el
Gobierno	NC	gobierno
haya	VHfin	haber
confirmado	VLadj	confirmar
a	PREP	a
De	PREP	de
Guindos	NC	<unknown>
como	ADV	como
aspirante	ADJ	aspirante
22	CARD	@card@
ENE	NC	<unknown>
2018	CARD	@card@
-	DASH	-
12:22CET	NC	<unknown>
