a	A
abajo	A
abandonado	B
abandonar	A
abandono	B	
abeja	B
abierto	A	
abogado	A
abonar	A
abono	B
aborto	B
abrazar	A
abrazo	A
abrebotellas	A
abrelatas	A
abrigo	A
abril	A
abrir	A
absolver	A
abstracto	B
absurdo	A
abuela	A
abuelo	A
aburrido	A
aburrir	A
abusar	B
abuso	B