días	NC	día
‘	NC	<unknown>
nació	VLfin	nacer
’	VLfin	<unknown>
milmillonario	NC	<unknown>
Foro	NC	foro
Económico	ADJ	económico
propone	VLfin	proponer
nuevo	ADJ	nuevo
índice	NC	índice
medir	VLinf	medir
desempeño	NC	desempeño
económico	ADJ	económico
forma	NC	forma
más	ADV	más
inclusiva	ADJ	<unknown>
ocupa	VLfin	ocupar
puesto	NC	puesto
países	NC	país
inclusivos	ADJ	<unknown>
ENE	NC	<unknown>
10:15CET	NC	<unknown>
introducción	NC	introducción