facilidad	NC	facilidad
contratar	VLinf	contratar
pasa	NC	pasa
factura	NC	factura
Insead	VLfin	<unknown>
Adecco	ADV	<unknown>
https	NC	<unknown>
//elpais	VLfin	<unknown>
com/economia/2018/01/22/actualidad/1516619373_693954	VLfin	<unknown>
html	NC	<unknown>
país	NC	país
ocupa	VLfin	ocupar
posición	NC	posición
índice	NC	índice
competitividad	NC	competitividad
laboral	ADJ	laboral
encabezan	VLfin	encabezar
Estados	NC	estado
ENE	NC	<unknown>
13:36CET	NC	<unknown>
introducción	NC	introducción