Foro	NC	foro
Económico	ADJ	económico
Mundial	ADJ	mundial
momento	NC	momento
‘	NC	<unknown>
mujer	NC	mujer
Davos	NC	<unknown>
’	VLfin	<unknown>
https	NC	<unknown>
//elpais	VLfin	<unknown>
com/economia/2018/01/21/actualidad/1516545846_483897	VLfin	<unknown>
html	NC	<unknown>
Pese	ADV	pese
edición	NC	edición
año	NC	año
Foro	NC	foro
Económico	ADJ	económico
mujeres	NC	mujer
solo	NC	solo
suman	VLfin	sumar|sumir
participantes	NC	participante
ENE	NC	<unknown>
10:20CET	NC	<unknown>
introducción	NC	introducción